[WIN CONDITIONS]
1,60,10,10,10,5
[TILES]
T,T,T,T,T,T,T,T,T,T
T,P,D,D,P,D,P,D,P,T
T,P,D,D,P,D,D,D,P,T
T,P,D,P,D,P,D,P,P,T
T,D,G,D,D,D,P,D,D,T
T,D,D,D,D,M,P,P,P,T
T,P,P,P,P,P,P,P,N,T
T,P,D,N,P,D,D,P,D,T
T,P,g,N,P,P,P,P,D,T
T,P,D,T,P,P,P,P,N,T
T,P,P,P,P,P,E,P,P,T
T,T,T,T,T,T,T,T,T,T
[ACTORS]
D,3,1
D,3,3
D,6,6
D,9,6
D,3,7
D,10,8
P,1,1
A,5,7,10
B,1,4
B,2,4
B,1,8
B,3,5
B,2,8
BF,9,4,true,UP
R,8,8