[WIN CONDITIONS]
3,60,10,10,10,5
[TILES]
T,T,T,T,T,T,T,T,T,T
T,D,D,D,D,D,D,D,P,T
T,D,D,D,P,P,P,P,P,T
T,r,D,y,P,P,P,P,P,T
T,D,D,D,P,P,P,P,P,T
T,R,R,D,P,P,P,P,P,T
T,N,N,N,N,P,P,N,P,T
T,T,T,N,N,P,P,N,P,T
T,T,T,N,N,M,D,E,P,T
T,T,T,T,T,T,T,T,T,T
[ACTORS]
B,2,8
D,2,4
D,2,5
D,2,6
P,5,8
F,1,8,true,UP
A,5,5,1
