T,T,T,T,T,T,T,T,T
T,D,D,D,D,D,D,D,T
T,D,D,D,P,P,P,P,T
T,N,N,N,N,P,P,N,T
T,T,T,N,N,P,P,N,T
T,T,T,N,N,M,D,E,T
T,T,T,T,T,T,T,T,T