[WIN CONDITIONS]
3,60,10,10,20,3
[TILES]
T,T,T,T,T,T,T,T,T,T
T,D,D,D,D,D,D,D,P,T
T,D,D,D,P,P,P,D,P,T
T,r,D,r,D,D,D,P,P,T
T,D,D,D,P,P,P,P,P,T
T,R,R,D,P,M,P,P,P,T
T,N,D,N,N,P,P,N,P,T
T,T,D,D,N,D,N,N,P,T
T,T,T,D,D,P,D,E,P,T
T,T,T,T,T,T,T,T,T,T
[ACTORS]
D,2,4
D,2,5
D,2,6
P,1,1
F,1,8,true,UP
A,5,5,1
