T,T,T,T,T,T,T,T,T,T
T,D,D,D,D,D,D,D,P,T
T,D,D,D,P,P,P,P,P,T
T,D,D,D,P,P,P,P,P,T
T,N,N,N,N,P,P,N,P,T
T,T,T,N,N,P,P,N,P,T
T,T,T,N,N,M,D,E,P,T
T,T,T,T,T,T,T,T,T,T