[WIN CONDITIONS]
5,360,12,12,10,1
[TILES]
T,T,T,T,T,T,T,T,T,T,T,T
T,P,P,P,D,P,P,P,D,D,N,T
T,N,N,P,N,D,P,D,D,P,D,T
T,g,P,P,P,D,D,D,D,D,D,T
T,P,P,D,P,P,P,P,P,P,D,T
T,P,D,P,D,P,P,P,P,P,P,T
T,P,r,P,D,P,P,D,D,P,P,T
T,P,D,D,P,P,P,P,P,P,D,T
T,P,P,P,P,P,P,D,D,P,M,T
T,T,N,D,D,T,N,G,D,P,D,T
T,E,P,P,P,P,P,P,P,D,R,T
T,T,T,T,T,T,T,T,T,T,T,T
[ACTORS]
P,1,1
D,1,6
D,1,7
D,5,8
D,5,10
D,8,5
D,9,9
D,10,3
D,10,6
B,1,5
B,2,6
B,5,3
B,5,4
B,5,7
B,6,3
B,6,10
BF,8,3,true,UP
F,7,8,false,UP
R,8,9